Diptera_Cecidomyiidae_Smos_errantivirus_1	EYDRMLYEN------------------DNIMS-RSKRS----------APLSTVGKIFKVVFGVMDEEDATKYEEKTNEI-----------VRKVNVHNDMLEEQTTIIMKTINSSNQTLHDFQN
Polyneoptera_Blattodea_Rspe_errantivirus_4	QIDSFTQML--------------------PRK-DRRR-----------GLVNVVGSVFKALFGVATVIDLDQLHDSVNKL-----------HDTQSDLVHSVNEQLTYLRSLDSLVKFNSKSVKS
Malacostraca_Decapoda_Esin_errantivirus_2	DLNNFLAAM-------------SGRDGSPFRT-RRRR-----------GAVDFVGSVANLLFGTATQAQIDVIHEKLSNL-----------HALSSEERRQLNLHTEVLNATVRDLRHVHSAISR
Coleoptera_Elateridae_Amur_errantivirus_4	ILKR------------NWDIEE---FKINDNN-RRRR-----------A-LDFLGDGLSWCCGVATQRKLDSLVNNENTL-----------NTNIKVMQEGLTETLKRIGEDSTHFQRYEHELSS
Polyneoptera_Orthoptera_Vvia_errantivirus_3	EFYNILEIL------------------PHKPN-RIRR-----------SYFALGGKILKTVFGTLNSEDLEHLESRLNNL-----------EAVGNDVKLSLSSQLILIQHMEESITNHTQAIQV
Diptera_Tipulidae_Nfla_errantivirus_2	QISQLILEL--------KNQK----------S-KNKR------------SIDWIGSAWKWIAGSPDATDWDQVVRSQNQI-----------IDNN-------NQQYKINRVLIDTSQQMLSEYNK
Diptera_Dolichopodidae_Pnob_errantivirus_3	LLQTKVHGL--------RPHI------------IGKR-----------GLLNFLGSGIKVLTGNMDSEDEQFIKTNLGKL-----------SKTNSELITESNKQISVNKQISDQISKISNHINY
Coleoptera_Curculionidae_Cass_errantivirus_5	RIENNIRQI--------DPTS-------SYSK-RQKR-----------GILNPLGSLIKCITGNLDKDDADLYDRQIRQL-----------QENQDKLKKSSFNQINLLGKTIEQFQNVISNISA
Polyneoptera_Plecoptera_Npic_errantivirus_4	HLTNLLHTL--------APV---------GQQ-RTKR-----------GLANFVGSSMKFLFGSMDSADSHAINARLKVA-----------EGKNEAIVHLVKEQLTYINDSYHTGLQNERNVRK
Cnidaria_Anthozoa_Pret_errantivirus_1	ELEYHLQKL--------------------TVN-RRKR-----------GLINGLGTVVKFISGNLDNNDLDKINNQLDKL-----------QNGRNKDLVRIDKLTVIANHISHRLSEQTDVINN
Hemiptera_Aphrophoridae_Pspu_errantivirus_5	DIQRHTASTHDW--------------SGIGGH-RTPR-----------A-ISSIGDMFHWCCGTATDDELHVLTTNEEAV-----------NTHINNMQRVMKDDHADLVTTATSLQGYTRNVSA
Annelida_Polychaeta_Lcla_errantivirus_4	HLTTLTIFT-------------------NSRL-RPKR-----------GLVNIVGKISSFLFGTATSEEVKVIKEGLVAA-----------QKNGAILYHNQKRLLAVVNKTRMYVQELYHKEDL
Diptera_Acroceridae_Aorb_errantivirus_3	NVRNKFKIV--------YELL------GNQDR-KYRR-----------GLINAIGSGLKVLFGTMDDSDAQYYQNATQTL-----------AQNQEFIQTAMQEEIKIVKSINEQNQVLKTTTKY
Hymenoptera_Apoidea_Aful_errantivirus_2	VLKLKEQDL----------------KDLIGHK-RVKR-----------GWFNAVGTVFKTIIGTMDNNDAEYYNDAIERI-----------NANEQELSDLMKAQVQVVQTTIANFNETIGSIHK
Annelida_Polychaeta_Pdum_errantivirus_8	ETKSFTASL------------------FPNSG-RSKR-----------SLLPFLGDILSGITGVATEKDINLINNHLSTM-----------QSQNERLGHIVQDSITVVNASKIQLTQVTETVND
Thecostraca_Balanomorpha_Aamp_errantivirus_3	NYQRDLDVI--------------KRVAVQNDA-RQTR-----------GLVNVVSNVGKYLFGFSTEKDTKKLAERINQL-----------AAQGGRLNHLVEQQLSYIDSVSTQALHNGEQINR
Hemiptera_Cicadellidae_Hvit_errantivirus_1	KTSDLVTLL--------------------PRT-QKKR-----------GLFDAGGHVLKFLFGTVIDSDLEVMNSKIDDA-----------NIRNDEIYHDTKDQLTVLDNMHLEILNHSRVINK
Polyneoptera_Plecoptera_Pmon_errantivirus_1	QLYNIMLTL--------AP----------ANR-MNKR-----------SPFNFVGTSLKYLFGTAVNSDVEIINSKLSRM-----------TSTDEEVVHLLAHQITFINQTANVGNRNSVDIRN
Coleoptera_Carabidae_Nbre_errantivirus_7	RLNHLLKTV--------APY---------ESE-RVKR-----------GLINVGGSALKWLFGTADSTDLITINDKINTL-----------QTKSDGILNVMDEQVTIVKNIENKNSKMKANFEK
Mollusca_Gastropoda_Gmag_errantivirus_4	DINSLIPTL----------------RLQNTDS-RQRR--------------NIIAEISKGLFGLATDHDLQILAHHLQQL-----------ARRTDNMTHSFDETHALMTSFMTKTNERISNAID
Hexanauplia_Cyclopoida_Pnan_errantivirus_2	VTNYYLKKT------GTNPIA----------T-REKRFI---GILL-AGLAGMVGGA--TLFGLFENGKLQALANGIEDL-----------RFRQQKMIHLIEGLDNNIRTNSHNIKQITKVLDK
Lepidoptera_Crambidae_Cpal_errantivirus_10	KIEKSFEQL-----------------ASLEPS-RAKR-----------GLINTFGTVIKSITGNLDYDDALKYDNAIKTL-----------HSNEDKLAFELNNHISYSKEWMTKHFGIISQIVE
Hymenoptera_Apoidea_Amin_errantivirus_1	LIRTAIGDT------------------THLKTPSPRRS----------VPFGFIGSISKTLFGTLSQEDAEYYNQELNKV-----------YRDQREITEIIANQTHIIKGEFSITHARLVNLTK
Lepidoptera_Noctuidae_Acen_errantivirus_7	LISKKLVFI--------APHH------------RFRR-----------GFINGLGSIVKTITGNLDYEDAIKFENDISKL-----------RNSVNKINVSQKQSLFIAKHAVEEYSKQIKFLDE
Hemiptera_Delphacidae_Nlug_errantivirus_6	NLFEKLSLL--------FPS--------YPSS-RKKR-----------GLFNGLGKAISWFTGNLDADDKNNYDQIINQL-----------EENEKILIENEKKNIVVNNNLVDKFNYDLNRINS
Diptera_Syrphidae_Maur_errantivirus_1	YNNEILDSI------------------LFKNK-FSKRSIVDG------GLFNGVGMAEKFLFGTMDSKDAEKIDDSLRLI-----------QENQNNLHHITENQMTIITDVLDALNKTAENINS
Polyneoptera_Plecoptera_Npic_errantivirus_3	QLEQLIYTL--------APVYT-----------REKR-----------SLIDGGGILLNFLFGTGDTGTFNTINSKIESM-----------NKTNQGIVHLLQDQITYINDSFATGHKNERSIST
Coleoptera_Elateridae_Alin_errantivirus_6	TTQQKFENL--------HPHI------------RNKR-----------GAINGIGKINKWLFGNLDADDEKRYDHAINVL-----------EQNQKDLTHEINLQISLSKKLIANYNKTIIILNK
Lepidoptera_Erebidae_Emi_errantivirus_18	ITLEKYSQL--------IPSI------------RIKR-----------GLINPIGSIVKAITGNLDNQDALKYDSLINNM-----------QVKQNQVI----NKITLISEMVDALINTTNSTRN
Diptera_Culicidae_Aaeg_errantivirus_15	HLYNTYYKL--------KPNVH-----------RRKR-------------WDSLGTAWKWIAGNPDAEDLRIINQTMNNL-----------IEYN-------NQQVFVNNAMDTRIQQISKITND
Diptera_Stratiomyidae_Hill_errantivirus_1	ETNNKLISL--------MPKT------------RNRR-----------GLINGLGTIIKTITGNLDANDAIRINSKINQI-----------LNNENVINKQINQQTQLNQQMIKRFENITNHINH
Lepidoptera_Erebidae_Emi_errantivirus_2	KIGKLSIQL-----------------RSLEPD-RVKR-----------GLVDSFGSVIKSITGNLDYTDALKYNNAIQIL-----------QSNQDKLANEFNNHISLSKEWMNKHNSVLLQLVE
Lepidoptera_Erebidae_Htar_errantivirus_3	LTKDRLKQI--------IPTK------------RLKR-----------GLINPLGSLVKLISGNLDNDDAMRYNSEISHL-----------KNKEHSVE----RKLSLMQKAFDKLVNITDDLKY
Hemiptera_Reduviidae_Tinf_errantivirus_3	LIQEKLEVV---------------TVRNNIKS-KTKR-----------GLVNGLGSIVKLIAGNLDAEDGQRYEN----L-----------KHNQENIESQLSSQYSINVDIIKQFNSTISVIED
Lepidoptera_Erebidae_Emi_errantivirus_10	KLISISKKI-----------------SMFEAS-RSKR-----------GLIDGLGSVIKSISGNLDYTDALKYENAINTL-----------RNNEHKLELEINNHVSLNTKFISHSSQIISSIIS
Lepidoptera_Hesperiidae_Hcom_errantivirus_1	KIKEISSQL----------------DTFLPTK-RAKR-----------GLINPLGSVIKSITGNLDYNDAVRYEQMFHIL-----------QKSDVDLTNSFNNHISLYKQMTFHQTEILSNLSS
Diptera_Stratiomyidae_Nnig_errantivirus_12	KIRSLIANL--------RPR-------------RLTR-----------S-LNFLGTAWKWLAGSPDHEDAITITEKLNNA-----------LQNN-------NKQVVINRLYNDRINNITRIANK
Diptera_Drosophilidae_Dana_errantivirus_5	IIKILMSQL--------IPS-------------RNKR-----------G-INELGTAWKWLAGTPDHDDLIRIENKINEL-----------TEN-------NNKQFTINSRIFQEVQLMTKILNT
Palaeoptera_Odonata_Ppen_errantivirus_1	EIEQTRSVI--------NQVA----RSGENPL-RFKR-----------GALNFIGEIGKVLFGTMDDDDATYYSRKIEEL-----------EGERSNILRLAKEQMTVVKSTLRTINSTVQNIQT
Diptera_Sciomyzidae_Cmar_errantivirus_6	LANNTLNTI--------IPVT-------HTEK-RGKR-----------GLFNIAGKAIKFLYGTMDNDDAVEIYSHLQNL-----------DKNSRQMTDQINKQVIINNDLIKNLKQVTEHVNK
Diptera_Culicidae_Aaeg_errantivirus_14	EINEYLKSI--------IPIR------------RQRR-------------WDAVGTVWKFIAGSPDANDLKLINNSINNL-----------IYNN-------NKQVKINREMTLQLKESVFKTKE
Diptera_Culicidae_Aaeg_errantivirus_9	KIHLTFNRI--------VPQN------------RFKR-------------WESLGRAWKYVSGSPDADDLKVINSTINSL-----------VTEN-------NNQIHINNVFEKRMRNLTRTFNL
Diptera_Culicidae_Aaeg_errantivirus_7	QTNMTFQKL-------------------SFRK-RSKRA------------INILGTLVKTITGNLDNNDLITLNQNINFL-----------QNSNKNLIESNNQQIKINNQFEDRMNNLTRVIFN
Diptera_Drosophilidae_Dmel_errantivirus_8	KIKRELAGI-------------------TLKH-RNKR-----------GLINIVGSGFKYLFGTLDENDRVEIQKKLEIN-----------VHNSVKL---------------HELNDAIRLIND
Hymenoptera_Apoidea_Amin_errantivirus_2	YSANLLLSV----------------GTSESEQ-RQKR-----------GWFNFVGEISKTLFGTMTNEDAEYYNREIDKV-----------ISSQNSLAKLIANETHILKTSALDADLFEKKLNL
Coleoptera_Melyridae_Mbip_errantivirus_14	HLKSQIKLI--------HPDA-----LTSPKN-RTER-----------GLFNGIGSIFKFISGNLDADDGERYDEAISKL-----------SNNQENIIKHFNKQLSMNSRLIQNFQQIIGNISS
Hemiptera_Acanthosomatidae_Ahae_errantivirus_5	QTQNKLNLL------------------KSHNK-RTKR-----------GLINGLGTALSWLTGTMTADDKSHYDEVINEL-----------GRNNYNIEHNIEQDIKLNKHVIKNFQKDIQLINN
Collembola_Symphypleona_Saqu_errantivirus_2	SLEATTTESPVIA---TTPKP------TERSRFRTGRSLGMLGRFDPRRVTSFIGAA---AMGYARSEDLDSLQTTVENITEYFEALGDNYSKEDQRILLNHQEQLHFENSTTIKLESMRDTLHG
Mollusca_Bivalvia_Fwhi_errantivirus_1	ELFPLMSLV--------------------NKT-RNRR-----------SLLPFVGDAMSWLFGVVSESDLRNIRNQVSSL-----------ESNQKQIVHIVEQSLTIINESRTLIRENRRTMSI
Coleoptera_Chrysomelidae_Pcoc_errantivirus_4	SLGLKYREI---------------FADTKPGH-RTKR-----------GIFNGAGSFWKAITGNLDASDGEYFNDCINKI-----------SKDEYQLENLMKNQISVTTSVIKSFNNTIQKLQI
Mollusca_Bivalvia_Hhip_errantivirus_1	TIMTLIPET------------------KIHRS-RSRR-----------SLLPFIGKLSKGLFGTATMDDVNILANHMNKL-----------TVFNEKLSKALTQQANHLSSYMSSANHRMDNLMA
Lepidoptera_Ypsolophidae_Yseq_errantivirus_2	HVEEMCNHL-------------------ALQR-RNKR-----------GLINGLGSIIKSITGNLDEDDYRNIQKDLETL------------------KIAYNQQISVTDESLEEYNKQLSKITE
Hymenoptera_Chalcidoidea_Mrap_errantivirus_1	EIYQDLQEI--------APFSG-----------RRKR-----------GLINGVGKVIKYIFGNPDSDDLEKINNYLENF-----------EKQQ-------NEDISVLNKTISCMNQISRTINS
Annelida_Polychaeta_Slim_errantivirus_21	QTRQTMDTIKLFL---ANPIS-------KKTD-RNKRE----------AIFGFLGDLFKGVFGVATMQDIDNIATALANIDYVLGAFKNQNIDTAELLQKVVKEQNSFRNTYISERSILNGALTD
Lepidoptera_Pyralidae_Efla_errantivirus_5	KLQKISDQL-----------------ETFEVS-RFKR-----------GLIDGLGSIIKSISGNLDYTDAIRYDNAIKSL-----------QSNEEKLASEYNSHVSLCKEWISAHSAVIDSMVE
Diptera_Sciomyzidae_Cmar_errantivirus_19	EIDRIISAI-------------------RVNR-RFARS------------IDFLGSALKFIAGTPDHEDWELLVTKQKIL-----------IENS-------NRQTRINSMIQDKINELTGRINI
Hymenoptera_Tenthredinoidea_Tmes_errantivirus_1	KVDRGLQLV--------RDVT------CVGPA-RKRR-----------GLIDGLGSIAKSLFGTMDAADAARIDQEIDDL-----------REDQANLKKTMSKQIQIVSSTLGVFNNTMRVVEE
Coleoptera_Curculionidae_Cass_errantivirus_1	RVDNKIKEI--------IPQP----------Q-RTKR-----------GLINGLGSIFKSVTGNLDADDGERYENLIREL-----------QGNQKNLQANILKQNSLSLTVIEKFNTTIKQINY
Lepidoptera_Hesperiidae_Hcom_errantivirus_3	KLQSVSDQL-----------------DTFQLK-RVKR-----------GLIDGLGSIIKSISGNLDYTDAIRYNRAIEVL-----------QDSNNKLVTEFNSHVSITKEWMAHYSELITNLVK
Malacostraca_Decapoda_Blat_errantivirus_1	SLNDYLSSL-------------LNDATTPSGS-RSKR-----------GAFNVLGTISNALFGTATQEQIDLIHHQLGNI-----------ESFTEEERLELNLHTKILNATVRDMRAMKRAIQR
Hymenoptera_Apoidea_Bhyp_errantivirus_1	NLKQLAKHL--------KALT---------HT-RSTR-----------GLLNIIGSVSQSLFGTLDDDDLTLINKNMDKL-----------FDDNNKIKTIIANQTALIRKIVNSEN-----LNH
Polyneoptera_Orthoptera_Vvia_errantivirus_4	QIRRNQELL---------------GQITERGS-RPKR-----------AVLGIIGDLSRILFGTLTQEDTRKLRSHINRL-----------EAEQGELLRVNQEQLTIVKTTLDAINVTLDTVER
Diptera_Clusiidae_Ctig_errantivirus_22	QSFEILESF--------SPIK---------HN-KAKR-----------S-INIIGTAWKYIAGSPDHDDLELINNNLKDL-----------NNNN-------NKQVIINQAFNERINNLTKLANE
Diptera_Pipunculidae_Nscu_errantivirus_2	HLKRKISNL--------KPHP------------KVKR-----------ALMNILGTGLKYIAGTMDSQDEIEIKSQLKAL-----------KSKNKELISENNKQVSFNFKISQQIENITNHIRN
Palaeoptera_Odonata_Iele_errantivirus_4	ELETLVDLV--------------------KKK-RVRR-----------GWIDAGGSLLKMVLGTADAEDLRQLNGRIEKL-----------EREGGDAHAAIGAQLLVLKGMEGRVANNTRFLRS
Diptera_Drosophilidae_Dwil_errantivirus_4	RISTLIGTL-------------------RVHH-RYARS------------LNILGTALKVVAGTPDFDDWEQVKFRQNQL-----------SEQG-------NRQIEINSKLQDRLNKLTNSLNE
Lepidoptera_Gelechiidae_Pgos_errantivirus_6	ITIQKFKQI--------MPFS------------RVRR-----------GLLNPLGSMIKVITGNLDHDDALRYDKLISQM-----------KGNEIKRE----HQMSIILKMVNTIINNTETLQN
Diptera_Culicidae_Aaeg_errantivirus_1	EIRSIYNTL-------NIPRV------------RSKRA------------IELLGSAVKFITGNLDAEDLKIINSNLEEL-----------KKNGNTYVKQNNRQIKINSKFENRLDLINKQIRD
Diptera_Stratiomyidae_Nnig_errantivirus_3	TVTAKIKSI--------IPSSV---------K-RQKR-----------GLLNIVGNAQKWLFGTMDSNDREEIVNHLQII-----------EENNHNAINNLNGQIKINNHFNESISSLQVIINN
Coleoptera_Chrysomelidae_Dbal_errantivirus_14	SAEQKFNSL--------LPPF------------RSKR-----------GLIDGLGSIIKSISGNLDSSDALLYDQAISDL-----------QNNNQILVKKVNQQISLTKDIIANFNETVTLIKN
Mollusca_Bivalvia_Tcro_errantivirus_3	NLNILLREY------------------QILMT-RSKR-----------SILPFVGKLSTFLFGTVNEDQLRGLKVAINQL-----------GRQQSNLVHVVQEQITVMNRSRELISENRLAINQ
Coleoptera_Tenebrionidae_Tcon_errantivirus_1	NLEEKSETI--------SHLI------GRKRN-IQKR-----------GLIDGVSYAFKWLFGTPDAEDATFYTDSINDL-----------VHQNHETKLLLKQQINILSSAISNYNQSAQLLKS
Arachnida_Scorpiones_Cscu_errantivirus_3	EYVALKTLV-----------------TLNNIT-RERR-----------GLINAGGKILKYLFGTATSEDIETLNNKLSQL-----------SETNEEFIHLIQSQATLLNDTLRIAKINRQQIYS
Annelida_Polychaeta_Pdum_errantivirus_2	RRQHMLDTL---------------KKAESGSR-RSKR-----------GLLDFGGTILSALFGVATTSQLRRFKSAMLEL-----------HDNQKDLAHASNTMASVLNQTRSLTLALADKQAS
Collembola_Entomobryomorpha_Scur_errantivirus_1	DTEELLNYS--------LPNK---EDLDFDSS-MTRR-----------G-LDWAGSFLNWCCSVAEQNSLDSLAKDEGDL---------------SKLVDHLKNQVTVDHQAAVHNNDIVNRYSK
Annelida_Polychaeta_Apac_errantivirus_2	RLIRIDNMI------------------NKDKH-RHKR-----------GLLDVGGLVLHELFGVATDKDLHKYQEMVTHL-----------KADTDAVIHIIPELTSVMNQTRIYTQKNRERINQ
Mollusca_Bivalvia_Mvir_errantivirus_2	LIKDLFEEH-------------DHKIMKKRKT-RSKR-----------AILSFVGQLSKTLFGTATIDDVNILARHINEL-----------TTRTIKITNALTKHDQHESSFMQTVDKRISKVVS
Hymenoptera_Chalcidoidea_Pcof_errantivirus_1	SLTQKLSLF--------QPHP------VEAKN-RKKR-----------GLFNFVGSVNKFLFGTMDANDAEYYNQEIDKL-----------YNHTGKALLAVRNQTIFMQDTFNEFSKEFHTFKN
Cnidaria_Anthozoa_Dlin_errantivirus_6	SYRDSLAKCKEWALKSCKRISSEEMIWLKAKR-RQSRS----SWACTAGVFGLFKFIYESTGHTCQSKHVDNLKGTLKQLSKT--------MRISQKLIRVVNGKTVYLMKITDKINSKLHQLTD
Coleoptera_Cerambycidae_Rmac_errantivirus_9	QVENKLKNV--------KPLG---------NT-RTKR-----------ALFNAVGKASKWAFGTLDSDDAKRYDNAIFTL-----------ESNQKEMHTDLENYLTITKNFMNETILTFEKITL
Cnidaria_Anthozoa_Cgra_errantivirus_5	HYQPTLAACKAWALTNCQGISAHERMFLNGHS-RRKRS----SFMCHAGLLGVLRAIYISLGHSCEPNHISSLKDTLRSMTHS--------LGLSQSMLRVINGKFIYLMKTTDSMTTKINRLSQ
Annelida_Polychaeta_Slim_errantivirus_16	QINASTSTLTLFL---SDPIN-------SKQE-RIKRG----------AILGFLGEAFKGLFGLATTKDINNLVGTVTNIDFVLKQFATQDQNTAKLITKITEKQDNMYHTYVQDKESNKNLFSS
Branchiopoda_Diplostraca_Dcar_errantivirus_3	RLTTCAMTL-------------------TGAA-RAKR-----------GVIDLGGTALKWLFGVSTQADLVELNKKIDAM-----------GNQKQEIVHVLEQHASIINESLQLSRSSVALLQE
Tunicata_Appendicularia_Odio_errantivirus_3	ELTAIAELV----NN------------------RRKR--------------------------DTDEEDVVPTDEDYDTI---------QNYDYDNFTSRERRSSTSAVSFFAPLLSSFIPVIPT
Hemiptera_Aphididae_Mdir_errantivirus_1	DIEKTRQQI---------------NYAVSRNE-RYRR-----------GLINGIGRLSKTLFGICSDEDYEFFDKKISEI-----------SEKQSRVIHDMRQQTRIVQSTVHDVDRAMVKIQQ
Polyneoptera_Blattodea_Rspe_errantivirus_5	KLNYLKQFL--------------------PKL-DPRR-----------GLVNLGGVILKTLFGTATVSDLHSLHEVLNEL-----------QLREQDIVSSLANHVTYMKRLDTITNTNSEVLTN
fish_Cyprinodontiformes_Fhet_vERV_1	QLQKFIVTE----------------EDLGGSK-RPKRF--LGGLI---ASVAAIGSLFSVGLSAANSVSLKTVQRHVQEL-----------DEEMPEIQQRLLLQQTLLNIQTKTLQGTMVTVNL
jawless_fish_Petromyzontiformes_Pmar_vERV_1	QLQRTMILP----------------PTTPNTT-RPKRSIGLGGAF---GILSGLSSLITLGVSISNAVKIGHLTQGVENL-----------QLDMRQIRRQIQHQQNNLIEMGSTLRDTVVLVNL
